5 10
|--------|
|.<.|..-.|
|*.-|.@*.|
|.<....-.|
|--------|